1111111111111
10011111000C1
1000011111001
1P0011E011111
1000000000001
1000000000001
1000010000001
1000101010101
1111111111111