111111111111111111111
111111C100000000001C1
111111C101110011101C1
1ECCCC0010CCCCC0100C1
111111C101111111101C1
111111C100000000001C1
111111C101111111101C1
1CCCCCCCCCCC11CCCCCC1
1C1111C1111C11C1111C1
1CCC11CCCCCC0PCCCCCC1
111C11C1C11111111C1C1
1CCCCCC1CCCC11CCCC1C1
1C111111111C11C111111
111111111111111111111