1111111111111111111111111111111
1P00000000C000000000000000000E1
1000000000000000000000000000001
1000000000000000000000X00000001
1000000000000000000000000000001
100000000000C000000000000C00001
10000000000000000000000000X0001
1000000000000000000000000000001
100C000000000000000000000000001
1000000000000X00000000000000001
1000000000000000000000000C00001
1000000000000000000000000000001
1000000000000000000000000000001
100000000000C00000000000000X001
10X0000000000000000000000000001
1111111111111111111111111111111