11111111111111111111111111111111
1P00000000C0000000000000000000E1
10000000000000000000000000000001
10000000000000000000000X00000001
10000000000000000000000000000001
1000000000000C000000000000C00001
100000000000000000000000000X0001
10000000000000000000000000000001
100C0000000000000000000000000001
10000000000000X00000000000000001
10000000000000000000000000C00001
10000000000000000000000000000001
10000000000000000000000000000001
100000000000C000000000000000X001
10X00000000000000000000000000001
11111111111111111111111111111111