111111111
1P0C00XE1
100000001
111111111