1111111
1101011
1001111
10P1111
100C111
1101011
1111111