11111111111111111111111111111111
1X000000000000000001111111111111
11111111111111111011111111111111
1X000000000011111011111111111111
11111111111011111011111111111111
1X000011111011111011111111111111
11111011111011111011111111111111
1X000PCCCCCCCCCCCCCCCCCCCCCCCCE1
11011111011111011111111111111111
1X011111011111011111111111111111
11111111011111011111111111111111
1X000000011111011111111111111111
11111111111111011111111111111111
1X000000000000011111111111111111
11111111111111111111111111111111