1111111
1P00001
1000001
1C00001
1000101
1111101
1110001
1110001
1110001
1110001
1110001
1110001
1110001
10000E1
1111111