11111111111111111111111111111111
1P00000000C0000000000000000000E1
10000000000000000000000000000001
10000000000000000000000000000001
10000000000000000000000000000001
10000000000000000000000000000001
10000000000000000000000000000001
10000000000000000000000000000001
100C0000000000000000000000000001
10000000000000000000000000000001
1000000000000000000000000C000001
10000000000000000000000000000001
10000000000000000000000000000001
100000000000C0000000000000000001
10000000000000000000000000000001
10000000000000000000000000000001
11111111111111111111111111111111