1111111111111
1EX00000000C1
1010101C10101
1010101C101X1
1P000000000C1
1111111111111