1111111
1101011
1001111
10P1E11
100C111
11P1011
1111111